Adie McCleary	Stupefy Global	Chief web officer	Brunei
Adie Throup	Levicorpus Services	Chief business officer	Maldives
Angie Delahaye	Cassiopeia Worldwide	Chief marketing officer	Singapore
Angie Furley	Plum and Sons	Chief commercial officer	Honduras
Aubrey Haskett	Jackfruit Farmers	Chief product officer	Uruguay
Aubrey McDuffee	Geminio Incorporated	Chief investment officer	Brazil
Barnes Wilkie	Watermelon Worldwide	Chief commercial officer	Philippines
Barry Wilkie	Dissendium Services	Chief communications officer	Morocco
Basil Henry	Blackberry and Sons	Chief data officer	Australia
Basil Horler	Grus and Sons	Chief diversity officer	Tunisia
Basil Willey	Avocado and Sons	Chief diversity officer	Liechtenstein
Benedict Nethersole	Expulso Global	Chief restructuring officer	Israel
Bernadine Abbitt	Cucumber Farmers	Chief investment officer	Brazil
Bernadine Batey	Mobiliarbus Global	Chief information officer	Lebanon
Bethany Murray	Expelliarmus Incorporated	Chief restructuring officer	Lesotho
Bette Crosby	Pack Services	Chief analytics officer	Bahrain
Bette Lloyd	Crucio Incorporated	Chief content officer	Hungary
Bette Makepeace	Elderberry Services	Chief business development officer	Gabon
Betty Buncle	Crux Farmers	Chief web officer	Bulgaria
Bradley Nettles	Avifors and Sons	Chief science officer	Jamaica
Bret Fitzroy	Flagrate Worldwide	Chief digital officer	Angola
Bret Tregarthen	Scutum Global	Chief visionary officer	Uganda
Brett Spratt	Vela Services	Chief operating officer	Indonesia
Britney Drinkwater	Incarcerous Technologies	Chief services officer	Benin
Carrington Colvin	Reducto and Sons	Chief compliance officer	Suriname
Clinton Lindley	Alohomora Technologies	Chief communications officer	Germany
Cowden Splatt	Elderberry Incorporated	Chief digital officer	Greece
Cristalyn Cantwell	Hercules Worldwide	Chief information security officer	Jamaica
Cristalyn Dickin	Bilberry Technologies	Chief compliance officer	Uruguay
Cristalyn Waide	Confringo Worldwide	Chief privacy officer	France
Daris Beaman	Colloportus and Sons	Chief knowledge officer	Micronesia
Darleen Philbrick	Orange Incorporated	Chief privacy officer	Albania
Darleen Stevens	Phoenix Farmers	Chief human resources officer	Bahamas
Darlene Barry	Peach Global	Chief strategy officer	Bangladesh
Debbie Couch	Nectarine Services	Chief administrative officer	Zimbabwe
Debbie Crockett	Durian Incorporated	Chief Scientific Officer	Bahamas
Debbie Travis	Aquarius Technologies	Chief analytics officer	Thailand
Debbie Trewartha	Cepheus Technologies	Chief information security officer	Azerbaijan
Demi Cheney	Mobiliarbus Incorporated	Chief technology officer	Uruguay
Destiny Waide	Gemini Incorporated	Chief Scientific Officer	Albania
Diamond Colvin	Microscopium and Sons	Chief privacy officer	Zimbabwe
Diamond Meyers	Clementine Ltd.	Chief process officer	Dominica
Doreen Philbrick	Raspberry Global	Chief data officer	Aruba
Dorian Crittenden	Sectumsempra Ltd.	Chief financial officer	Suriname
Dorian Fawkes	Cassiopeia Ltd.	Chief restructuring officer	Timor-Leste
Dorothy Haskett	Nox Ltd.	Chief visibility officer	Guinea
Edith Travis	Chamaeleon Technologies	Chief technology officer	Lebanon
Gabriel Abbiss	Cancer Farmers	Chief reputation officer	Bangladesh
Georgiana Osgood	Boysenberry and Sons	Chief reputation officer	Tunisia
Greenbury Crockett	Engorgio Ltd.	Chief design officer	Bangladesh
Greig Murray	Anapneo Technologies	Chief services officer	Brunei
Hannah Botting	Aparecium Incorporated	Chief web officer	Afghanistan
Hannah McDuffee	Blackberry Incorporated	Chief privacy officer	Samoa
Harley Abbitt	Musca Services	Chief content officer	Austria
Harley Cann	Damson Global	Chief knowledge officer	Colombia
Harriet Cavendish	Reparo Ltd.	Chief information officer	Jordan
Harriet Penberthy	Pyxis Worldwide	Chief business development officer	Laos
Harriet Pierce	Honeyberry Global	Chief executive officer	Uganda
Heather Trewartha	Deprimo Incorporated	Chief experience officer	Bahamas
Henrietta Cantwell	Feijoa Ltd.	Chief design officer	Brazil
Henrietta Elphinstone	Salak Technologies	Chief information officer	Bahamas
Henrietta Tregarthen	Cloudberry Incorporated	Chief sustainability officer	Guernsey
Heston Murnaghan	Expelliarmus Services	Chief creative officer	Gabon
Holly Beale	Imperio Farmers	Chief business officer	Israel
Holly Buncle	Redcurrant Services	Chief security officer	Uganda
Howard Flann	Libra Global	Chief product officer	Swaziland
India Bewley	Durian and Sons	Chief information security officer	Australia
India Kirkland	Mandarine Technologies	Chief operating officer	Monaco
India Walle	Glisseo Worldwide	Chief operating officer	Belgium
Irene Nethersole	Satsuma Services	Chief business development officer	Tunisia
Iris Cann	Grape Ltd.	Chief gaming officer	Morocco
Iris Cantwell	Sectumsempra Technologies	Chief science officer	Turkey
Jackie Murnaghan	Eridanus Ltd.	Chief executive officer	Azerbaijan
Jade Horler	Gooseberry Incorporated	Chief content officer	Vietnam
James Splatt	Grapefruit Technologies	Chief compliance officer	Tajikistan
James Tonge	Obscuro Farmers	Chief customer officer	Australia
Jean Osborne	Expulso Farmers	Chief digital officer	Ireland
Jerald Speakman	Cantaloupe Technologies	Chief information security officer	Netherlands
Jerry Grover	Honeyberry Technologies	Chief visionary officer	Tuvalu
Jerry Ridyard	Horologium Farmers	Chief creative officer	Brunei
Jethro Midwinter	Reparo Farmers	Chief investment officer	Uganda
Jethro Travis	Furnunculus Farmers	Chief Scientific Officer	Armenia
Jigar Roper	Flagrate Services	Chief privacy officer	Cyprus
Joan Cawthon	Telescopium Services	Chief compliance officer	Brazil
Joan Delahaye	Crater and Sons	Chief business officer	Ghana
Joan Pott	Diffindo and Sons	Chief compliance officer	Honduras
Julia Philbrook	Camelopardalis Worldwide	Chief administrative officer	Australia
Julie Breathnach	Persimmon Incorporated	Chief gaming officer	Jordan
Julie Stallard	Apple Services	Chief diversity officer	Nicaragua
Julie Wortman	Aguamenti Ltd.	Chief financial officer	Tunisia
Kate Stickland	Pavo Global	Chief risk officer	Bolivia
Kathryn Abbs	Pomelo Technologies	Chief learning officer	Belgium
Kathryn Cruwys	Pegasus Services	Chief technology officer	Belgium
Kathryn Tonge	Lepus Services	Chief marketing officer	Brazil
Katie Stephens	Orion Global	Chief diversity officer	France
Keaton Penberthy	Erecto and Sons	Chief technology officer	Bahrain
Kendra Fawkes	Columba Technologies	Chief science officer	Guinea
Kerr Banister	Lepus Ltd.	Chief administrative officer	Lesotho
Kian Cann	Incarcerous Services	Chief process officer	Mongolia
Kimball Lindley	Corvus Ltd.	Chief operating officer	Brazil
Kristy Absalom	Tamarind Farmers	Chief technology officer	Jersey
Kristy Speakes	Orange Services	Chief services officer	Netherlands
Kylie Buncle	Coconut Technologies	Chief web officer	Bulgaria
Lawrence Furley	Olive and Sons	Chief commercial officer	Malawi
Lawrence Mullies	Pear Services	Chief brand officer	Turkey
Lawson Murray	Levicorpus Ltd.	Chief marketing officer	Suriname
Lawson Pott	Triangulum and Sons	Chief commercial officer	Guernsey
Lisa Murray	Huckleberry and Sons	Chief genealogical officer	Aruba
Lizzie Bonham	Salmonberry Incorporated	Chief process officer	Australia
Lizzie Lammie	Aquila Worldwide	Chief learning officer	Singapore
Lizzie Murnaghan	Reducto Services	Chief sustainability officer	Singapore
Lizzie Patten	Octans and Sons	Chief information security officer	Morocco
Lucius Stevens	Draco Incorporated	Chief design officer	Botswana
Lucretia Abbitt	Sectumsempra Farmers	Chief restructuring officer	Bahrain
Madelaine Henry	Norma Worldwide	Chief product officer	Micronesia
Madelaine Stallard	Riddikulus Technologies	Chief investment officer	Ireland
Madeleine Makepeace	Honeydew Incorporated	Chief genealogical officer	Singapore
Malford McDowell	Impedimenta and Sons	Chief product officer	Namibia
Marlene Ratliff	Raspberry Farmers	Chief security officer	Niue
Martin Bishop	Bishop Industries	Chief executive officer	Wales
Maud Wilkie	Horologium Worldwide	Chief risk officer	Guernsey
Melinda Makepeace	Musca Global	Chief operating officer	Malawi
Melville Lindley	Apus Worldwide	Chief research officer	Philippines
Melville Lloyd	Crux Services	Chief technology officer	Mali
Mildred Botting	Densaugeo Technologies	Chief digital officer	Guernsey
Mildred Culverhouse	Salmonberry Ltd.	Chief data officer	Guernsey
Mildred Hopley	Pomegranate Technologies	Chief compliance officer	Vanuatu
Mildred Wrigley	Strawberry Technologies	Chief administrative officer	Greece
Millicent Cann	Grape Incorporated	Chief diversity officer	Netherlands
Mindy Gingell	Deprimo and Sons	Chief visionary officer	Slovakia
Mindy Osgood	Reparo Farmers	Chief marketing officer	Japan
Mindy Wortman	Sculptor Technologies	Chief communications officer	Angola
Moira Splatt	Perseus Worldwide	Chief technology officer	Honduras
Molly Absalom	Crux Technologies	Chief information officer	Cyprus
Molly Botting	Orchideous Services	Chief brand officer	Cuba
Molly Willey	Jujube Incorporated	Chief services officer	Bahrain
Mort Mawer	Levicorpus Global	Chief strategy officer	Bangladesh
Nancy Banister	Cepheus Technologies	Chief reputation officer	Canada
Nancy Penberthy	Triangulum Worldwide	Chief science officer	Nicaragua
Nevaeh Drinkwater	Cancer Ltd.	Chief commercial officer	Ghana
Nevaeh Wallbank	Protego Services	Chief web officer	Iraq
Paris Pierce	Vulpecula Global	Chief marketing officer	Belgium
Pascoe Marmion	Phoenix Ltd.	Chief communications officer	Belarus
Patricia Cawthon	Satsuma and Sons	Chief human resources officer	Mongolia
Patricia Splatt	Hercules Services	Chief brand officer	Iraq
Percy Breathnach	Reducio and Sons	Chief knowledge officer	Aruba
Philip Grover	Damson Global	Chief communications officer	Indonesia
Philippa Ridyard	Libra Technologies	Chief reputation officer	Uganda
Philippa Tonge	Cherimoya Farmers	Chief knowledge officer	Andorra
Pippa Spratt	Blueberry and Sons	Chief digital officer	Morocco
Poppy Flann	Lynx Services	Chief compliance officer	Australia
Poppy McDuffee	Delphinus Services	Chief strategy officer	Brunei
Poppy Nethersole	Blackberry Ltd.	Chief customer officer	Luxembourg
Quentin Bewley	Riddikulus Global	Chief financial officer	Greece
Quintus Abbitt	Obscuro Technologies	Chief science officer	Malawi
Quintus Delahaye	Morsmorde Farmers	Chief research officer	Palau
Quintus Gingell	Duro Technologies	Chief Scientific Officer	Albania
Quintus Robason	Confringo Ltd.	Chief creative officer	Lebanon
Quintus Thew	Andromeda Farmers	Chief content officer	Bolivia
Rebecca Abbiss	Cherimoya Services	Chief design officer	Latvia
Rebecca Elphinstone	Volans Incorporated	Chief product officer	Hungary
Rebecca McCleary	Avifors Global	Chief information officer	Niue
Rebecca Stallard	Obscuro Global	Chief learning officer	Eritrea
Reynold Paynter	Delphinus Services	Chief customer officer	Austria
Rhoda Cantwell	Furnunculus Services	Chief security officer	Luxembourg
Rhoda Throup	Cucumber Farmers	Chief information security officer	Canada
Riley Irwin	Kumquat Services	Chief brand officer	Austria
Riley Osborne	Clementine Worldwide	Chief research officer	Bulgaria
Rita Lowe	Aries and Sons	Chief strategy officer	Belgium
Rita McDuffee	Pisces Farmers	Chief information security officer	Micronesia
Roland Bewley	Cherry Technologies	Chief gaming officer	Thailand
Roland Lockheart	Papaya Global	Chief executive officer	Liberia
Rosie Irwin	Sagittarius and Sons	Chief visionary officer	Luxembourg
Rupert Laws	Reducto Services	Chief creative officer	Belgium
Rupert Wrigley	Eridanus Global	Chief restructuring officer	Luxembourg
Ruth Botting	Impedimenta Technologies	Chief services officer	Armenia
Ruth Millidge	Nox Farmers	Chief information officer	Micronesia
Ryan Couch	Alohomora Ltd.	Chief information officer	Réunion
Ryan Lockhart	Grapefruit Incorporated	Chief diversity officer	Morocco
Sanford Cruwys	Cygnus and Sons	Chief financial officer	Singapore
Schuyler Couch	Gemini Incorporated	Chief communications officer	Cameroon
Schuyler Crockett	Blackcurrant and Sons	Chief reputation officer	Botswana
Scott Cawthon	Impedimenta Farmers	Chief design officer	Bulgaria
Scott Mildred	Jackfruit Ltd.	Chief marketing officer	Tunisia
Sheridan Cavendish	Pyxis Ltd.	Chief product officer	Philippines
Sibyl Lindley	Blueberry Worldwide	Chief web officer	Lebanon
Sidney Lloyd	Expelliarmus Global	Chief business officer	Bahrain
Simone Crittenden	Scruge Technologies	Chief information officer	Philippines
Stacy Rudd	Melon Global	Chief gaming officer	Singapore
Sylvia Pierce	Silencio Ltd.	Chief gaming officer	Tokelau
Tabitha Horler	Leo Global	Chief science officer	Austria
Tabitha Makepeace	Jackfruit Farmers	Chief visibility officer	Ghana
Tammy Grover	Grape Ltd.	Chief communications officer	Tunisia
Theodore Murnaghan	Nance Services	Chief experience officer	France
Trent Philbrook	Lepus and Sons	Chief reputation officer	Singapore
Tyler Buncle	Erecto Technologies	Chief customer officer	Austria
Tyler Haskett	Phoenix Farmers	Chief innovation officer	Lesotho
Tyler Ridyard	Nance Services	Chief human resources officer	Lebanon
Tyler Robason	Capricornus Worldwide	Chief financial officer	Vanuatu
Vicary Drinkwater	Pyxis Farmers	Chief brand officer	Vanuatu
Vince Kirkland	Homorphus and Sons	Chief research officer	Mongolia
